Ada	RLC
Albis	RLC
Aletsch	RLG
Allalin	RLX
Altels	RLG
Alvier	RLG
Arblatsch	RLC
Aubrig	RLC
Badile	RLC
Badus	RLC
Balm	RLC
Basodino	RLC
Bernina	RLG
Beverin	RLG
Born	RLC
Brisen	RLC
Brisi	RLG
Buin	RLC
Camilla	RLG
Castor	RLG
Chasseral	RLG
Chasseron	RLC
Clariden	RLC
Combin	RLG
Curver	RLC
Daint	RLG
Damma	RLX
Dauben	RLC
Dirru	RLX
Dolden	RLC
Dole	RLG
Dolf	RLC
Dom	RLG
Eiger	RLG
Ela	RLC
Etzel	RLC
Felli	RLC
Fess	RLG
Forbesch	RLX
Frumsel	RLC
Fulen	RLC
Gabris	RLG
Gauschla	RLC
Generoso	RLC
Giorgio	RLC
Glis	RLG
Gonzen	RLC
Gurten	RLC
Hahnen	RLC
Huser	RLC
Irchel	RLC
Jakob	RLC
Kamor	RLX
Kesch	RLC
Kron	RLC
Laggin	RLC
Leojyg	RLC
Leone	RLC
Lis	RLG
Ludwig	RLG
Madun	RLC
Marwees	RLC
Mitgel	RLC
Moleson	RLC
Monch	RLX
Montalin	RLG
Mythen	RLC
Nadel	RLG
Nair	RLG
Napf	RLC
Ofen	RLC
Owis	RLC
Palu	RLX
Parrot	RLG
Pilatus	RLG
Planggen	RLC
Pollux	RLG
Rauti	RLC
Riein	RLC
Roseg	RLC
Ross	RLC
Rubli	RLC
Salantin	RLC
Salvatore	RLC
Sardona	RLC
Sasanda	RLC
Segnas	RLG
Selun	RLC
Sezner	RLC
Silvretta	RLG
Speer	RLC
Surlej	RLG
Susten	RLC
Tamaro	RLC
Tambo	RLX
Tarantschun	RLC
Tasch	RLC
Terri	RLC
Tinzen	RLC
Titlis	RLC
Todi	RLC
Toissa	RLC
Tola	RLC
Tomli	RLG
Tomul	RLC
Uccello	RLC
Uetli	RLC
Varuna	RLC
Vreneli	RLC
Wasen	RLC
Zinal	RLG
Zindlen	RLC
Zupo	RLC
